111111111111111111111111111111
1P0000000011110000000C010000E1
100001111000000000001000010001
111111111111111111111111111111
