111111111111111111111111111111
1P0000000011110000000C01000001
100001111111000000001001010001
100001000000000000001001011001
1000010000000111100010010C1001
100001000000000010001001111001
1000010C000001C000011000000001
100001111111111110010010000001
100000000000000000010010000001
101011000000000000010010000001
100001000000000000010010C00001
100001000000000000111110000001
100000000C000000001C0000E00001
100001000000000000100000000001
111111111111111111111111111111
