111111111111111111111111111111
1P000C00C000C000110000C0000001
100000C000110000C000C000C00001
100000000001100000000000000001
10011100000100000C000000000001
100001000001000001000110000001
10000C0000010C0000100011000001
100001111001000000C00001000001
10000100001000C000000100001001
1000010000100000C0000100001001
100001000001111100000C00001001
100001C0000000000C000010000001
100001111111000000000010000001
10000000000000000C000010C00001
1E0000000000000000000000000001
111111111111111111111111111111
